Afrikaans – af
Albanian – sq
Amharic – am
Arabic – ar
Armenian – hy-AM
Azerbaijani – az-AZ
Bangla – bn-BD
Basque – eu-ES
Belarusian – be
Bulgarian – bg
Burmese – my-MM
Catalan – ca
Chinese (Hong Kong) – zh-HK
Chinese (Simplified) – zh-CN
Chinese (Traditional) – zh-TW
Croatian – hr
Czech – cs-CZ
Danish – da-DK
Dutch – nl-NL
Estonian – et
#Filipino – fil
Tagalog – tl
Finnish – fi-FI
French (Canada) – fr-CA
French (France) – fr-FR
Galician – gl-ES
Georgian – ka-GE
German – de-DE
Greek – el-GR
Gujarati – gu
Hebrew – iw-IL
Hindi – hi-IN
Hungarian – hu-HU
Icelandic – is-IS
Indonesian – id
Italian – it-IT
Japanese – ja-JP
Kannada – kn-IN
Kazakh – kk
Khmer – km-KH
Korean – ko-KR
Kyrgyz – ky-KG
Lao – lo-LA
Latvian – lv
Lithuanian – lt
Macedonian – mk-MK
Malay – ms
Malay (Malaysia) – ms-MY
Malayalam – ml-IN
Marathi – mr-IN
Mongolian – mn-MN
Nepali – ne-NP
Norwegian – nb-NO
Persian – fa
Polish – pl-PL
Portuguese (Brazil) – pt-BR
Portuguese (Portugal) – pt-PT
Punjabi – pa
Romanian – ro
Romansh – rm
Russian – ru-RU
Serbian – sr
Sinhala – si-LK
Slovak – sk
Slovenian – sl
Spanish (Spain) – es-ES
Spanish (United States) – es-US
Swahili – sw
Swedish – sv-SE
Tamil – ta-IN
Telugu – te-IN
Thai – th
Turkish – tr-TR
Ukrainian – uk
Urdu – ur
Vietnamese – vi
Zulu – zu